Alabama	AL 	
Alaska	AK 	
Arizona	AZ 	
Arkansas	AR 	
California	CA 	
Colorado	CO 	
Connecticut	CT 	
Delaware	DE 	
Florida	FL 	
Georgia	GA 	
Hawaii	HI 	
Idaho	ID 	
Illinois	IL 	
Indiana	IN 	
Iowa	IA 	
Kansas	KS 	
Kentucky	KY 	
Louisiana	LA 	
Maine	ME 	
Maryland	MD 	
Massachusetts	MA 	
Michigan	MI 	
Minnesota	MN 	
Mississippi	MS 	
Missouri	MO 	
Montana	MT 	
Nebraska	NE 	
Nevada	NV 	
NewXXHampshire  	NH 	
NewXXJersey  	NJ 	
NewXXMexico  	NM 	
NewXXYork  	NY 	
NorthXXCarolina  	NC 	
NorthXXDakota  	ND 	
Ohio	OH 	
Oklahoma	OK 	
Oregon	OR 	
Pennsylvania	PA 	
RhodeXXIsland  	RI 	
SouthXXCarolina  	SC 	
SouthXXDakota  	SD 	
Tennessee	TN 	
Texas	TX 	
Utah	UT 	
Vermont	VT 	
Virginia	VA 	
Washington	WA 	
WestXXVirginia  	WV 	
Wisconsin	WI 	
Wyoming	WY 	
